R 800 600
SO ./texture/4.xpm
NO ./texture/murviolet.xpm
EA ./texture/murbleu.xpm
WE ./texture/murbrique.xpm
F 30,144,255
C 225,30,67

S ./texture/murnoir.xpm

1111111111111111111
1001000000000000001
1000000200000000001
1000010000000001001
10000000N0001012101
1201011100001001001
1000000000001000001
1001000000201000001
1021000000001000001
1000000000000000001
1111111111111111111