R  800 600
NO ./texture/murviolet.xpm
SO      ./texture/4.xpm
WE ./texture/murbrique.xpm
EA ./texture/murbleu.xpm
S             ./texture/murnoir.xpm
F 30,144,255
C 255,144,255

        1111111111111111111111111
        1000000000110000000000001
        1011000001110000002000001
        1001000000000000000000001
111111111011000001110000000000001
100000000011000001110111111111111
11110111111111000100000010001
11110111111001010101010010001
11000000000000001100000010001
10002000000S00000100000000001
10000000000000000101010010001
110000011100000111110111100001111
11110111 1110101 101111010001
11111111 1111111 111111111111